#####A######
###   ######
###        #
### #### ###
##   B   ###